1 1 1 1 1 1 1 1 1 1 1 1 0 0 1 1
1 0 0 0 0 0 0 0 x 0 0 0 0 0 0 1
1 0 0 0 0 0 0 0 0 0 0 0 0 0 0 1
1 0 0 0 0 0 0 0 0 0 0 0 0 0 0 1
1 0 0 0 x 0 0 0 0 0 0 0 m m m 1
1 0 0 0 0 0 0 0 0 0 0 0 m m m 1
1 0 0 0 0 0 0 0 0 0 0 0 m m m 1
1 0 y 0 0 0 0 0 0 0 0 0 0 0 0 1
1 0 0 0 0 0 0 0 0 0 0 0 0 0 0 1
1 0 0 0 0 0 0 0 0 0 0 0 0 0 0 1
1 0 0 0 0 0 0 0 0 0 0 0 x 0 0 1
0 0 0 0 0 0 y 0 0 0 0 0 0 0 0 1
0 0 0 0 0 0 0 0 0 0 0 0 0 0 0 1
1 0 0 0 0 0 0 0 0 0 y 0 0 0 0 1
1 0 0 0 0 0 0 0 0 0 0 0 0 0 0 1
1 1 1 1 1 1 1 1 1 1 1 1 1 1 1 1