1 1 1 1 1 1 1 1 1 1 1 1 1 1 1 1
1 l l l 0 0 0 0 0 0 0 0 l l l 1
1 l l l 0 0 0 0 0 0 0 0 l l l 1
1 0 0 0 x 0 0 0 0 0 y 0 0 0 0 1
1 0 0 0 0 0 0 0 0 0 0 0 0 0 0 1
1 0 0 0 0 0 l l l l 0 0 0 0 0 1
1 0 0 0 0 0 l l l l 0 0 0 0 0 1
1 0 0 0 0 0 l l l l 0 0 0 0 0 1
1 0 0 0 0 0 l l l l 0 0 0 0 0 1
0 0 0 0 0 0 x 0 y 0 0 0 0 0 0 0
0 0 0 0 0 0 0 0 0 0 0 0 0 0 0 0
1 0 0 0 l l 0 0 0 0 l l 0 0 0 1
1 0 0 0 l l 0 0 0 0 l l 0 0 0 1
1 y 0 0 0 0 0 0 0 0 0 0 0 y 0 1
1 0 0 0 0 0 0 0 0 0 0 0 0 0 0 1
1 1 1 1 1 1 1 1 1 1 1 1 1 1 1 1