1 1 1 1 1 1 1 1 1 1 1 1 1 1 1 1
1 c c c c c 0 0 x 0 0 0 0 0 0 1
1 c c c c c 0 0 0 0 0 0 0 0 0 1
0 0 0 c c c 0 0 l l l l y 0 0 1
0 0 0 0 c c 0 0 l l l l 0 0 0 1
0 0 0 0 c c 0 0 l l l l 0 0 0 1
1 c c c c c 0 0 l l l l 0 0 0 1
1 c c c c c 0 0 l l l l 0 0 0 1
1 0 0 0 0 0 0 0 x 0 0 0 0 0 0 1
1 0 0 0 0 0 0 0 0 0 0 0 0 0 0 1
1 1 1 1 1 1 1 1 1 1 1 1 0 0 0 1
1 1 1 1 1 1 1 1 1 1 1 1 0 0 0 1
1 0 0 0 0 0 0 0 0 0 0 0 0 y 0 1
1 0 0 0 0 0 x 0 0 0 0 0 0 0 0 1
1 0 0 0 0 0 0 0 0 0 0 0 0 0 0 1
1 1 1 1 1 1 1 1 0 0 0 1 1 1 1 1