1 1 1 1 1 1 1 1 0 0 1 1 1 1 1 1
1 0 0 0 0 0 0 0 0 0 x 0 0 0 0 1
1 0 0 0 0 0 0 0 0 0 0 0 0 0 0 1
1 0 0 0 0 0 0 0 0 0 0 0 0 0 0 1
1 0 0 0 0 0 x 0 0 0 0 0 0 0 0 1
1 0 0 0 0 0 0 0 0 0 0 0 0 0 0 1
1 l l l l l l l l l c c l l l 1
1 l l l l l l l l l c c l l l 1
1 l l l l l l l l l c c l l l 1
0 0 0 0 c c 0 0 0 0 0 0 0 0 0 1
0 0 0 0 c c 0 0 0 0 0 0 0 0 0 1
1 c c c c c 0 0 y 0 0 0 0 0 0 1
1 c c c c c 0 0 y 0 0 0 0 0 0 1
1 0 0 0 x 0 0 0 0 0 0 0 y 0 0 1
1 0 0 0 x 0 0 0 0 0 0 0 y 0 0 1
1 1 1 1 1 1 1 1 1 1 1 1 1 1 1 1