1 0 0 0 1 1 1 1 1 1 1 1 1 1 1 1
1 0 0 0 0 0 | 0 x 0 0 0 0 0 0 1
1 0 0 0 0 0 | 0 0 0 0 0 0 0 0 1
1 0 0 0 0 0 | 0 0 0 0 y 0 0 0 1
1 0 0 0 0 0 | 0 0 0 0 0 0 0 0 1
1 0 0 0 0 0 | 0 0 0 0 0 0 0 0 1
1 0 0 0 r r r r r r x 0 0 0 0 1
1 0 0 0 r r r r r r 0 0 0 0 0 1
1 0 x 0 0 0 | 0 0 0 0 0 0 0 0 1
1 0 0 0 y 0 | 0 0 0 0 0 0 0 0 1
1 0 0 0 0 0 | 0 0 0 0 0 0 0 0 1
1 0 0 0 0 0 | 0 0 0 0 y 0 0 0 1
1 0 0 0 0 0 | 0 0 0 0 0 0 0 0 1
1 0 0 0 0 0 | 0 0 0 0 0 0 0 0 1
1 0 0 0 0 0 | 0 0 0 0 0 0 0 0 1
1 1 1 1 1 1 1 1 1 1 1 1 0 0 0 1