1 1 1 1 0 0 1 1 1 1 1 1 1 1 1 1
1 0 0 0 0 0 s s 0 0 0 0 0 0 0 1
1 0 0 0 0 0 s s 0 0 0 0 0 0 0 1
1 0 0 0 0 0 s s 0 0 0 0 0 0 0 1
1 0 0 0 0 0 s s 0 0 0 0 0 0 0 1
1 0 x 0 0 0 s s 0 0 0 0 0 0 0 1
1 0 0 0 0 0 s s 0 0 0 0 0 0 0 1
1 0 0 0 s s s s y 0 0 0 0 0 0 1
1 0 0 0 s s s s 0 0 0 0 0 0 0 1
1 0 0 0 0 0 0 0 0 0 0 0 0 0 0 1
1 0 0 0 0 0 0 0 0 0 0 0 0 0 0 1
1 0 y 0 0 0 0 0 0 0 y 0 0 0 0 1
1 0 0 0 0 0 0 0 0 0 0 0 0 0 0 1
1 0 0 0 0 0 0 0 0 0 0 0 0 0 0 1
1 0 0 0 0 0 0 0 0 0 0 0 0 0 0 1
1 1 1 1 1 1 0 0 1 1 1 1 1 1 1 1