1 1 1 1 1 1 1 1 1 1 1 1 1 1 1 1
1 0 s s 0 0 0 0 0 0 0 0 0 s s 1
1 0 s s 0 0 0 mb 0 0 0 0 0 s s 1
1 0 0 0 0 0 0 0 0 0 0 0 0 0 0 1
1 0 0 0 0 0 0 0 0 0 0 0 0 0 0 1
1 0 0 0 0 0 0 0 0 0 0 0 0 0 0 1
1 0 0 0 0 0 0 0 0 0 0 0 0 0 0 1
1 0 0 0 0 0 0 0 0 0 0 0 0 0 0 1
1 0 0 0 0 0 0 s 0 0 0 0 0 0 0 1
1 0 0 0 0 s s s 0 0 0 0 0 0 0 1
1 0 0 0 0 0 s s s 0 0 0 0 0 0 1
1 0 0 0 0 0 s 0 0 0 0 0 0 0 0 1
1 0 0 0 0 0 0 0 0 0 0 0 0 0 0 1
1 0 0 0 0 0 0 0 0 0 0 0 0 0 0 1
1 0 0 0 0 0 0 0 0 0 0 0 0 0 0 1
1 1 1 1 1 1 1 1 0 0 1 1 1 1 1 1