1 1 1 1 1 1 1 1 1 1 1 1 1 1 1 1
1 0 0 0 0 0 0 0 a a a a 0 0 0 1
1 0 0 0 0 0 0 0 a a a a 0 0 0 1
1 0 0 0 0 0 0 0 a a a a 0 0 0 0
1 0 0 0 y 0 0 0 a a a a 0 0 0 0
1 0 0 0 0 0 0 0 a a a a 0 0 0 0
1 0 0 0 0 0 a a x 0 0 0 0 0 0 1
1 0 0 0 0 0 a a 0 0 0 0 0 0 0 1
1 0 0 0 0 0 y 0 a a 0 0 0 0 0 1
0 0 0 0 0 0 0 0 a a 0 0 0 0 0 1
0 0 0 0 y 0 0 0 0 0 x 0 0 0 0 1
0 0 0 0 0 0 0 0 0 0 0 0 0 0 0 1
1 0 0 0 0 0 a a a a a a 0 0 0 1
1 0 0 0 0 0 a a a a a a 0 0 0 1
1 0 0 0 0 0 a a a a a a 0 0 0 1
1 1 1 1 1 1 1 1 1 1 1 1 1 1 1 1