1 1 1 1 1 1 1 1 1 1 1 1 1 0 0 1
1 0 0 0 l l 0 0 l 1 0 0 0 0 0 1
1 0 0 0 l l 0 0 l 1 0 0 0 0 0 1
1 0 0 0 l l 0 0 0 0 0 0 0 0 0 1
1 0 0 0 l l 0 0 0 0 0 0 0 0 0 1
1 0 0 0 l l 0 0 0 0 0 0 0 0 0 1
1 0 0 0 l l y 0 l l 0 0 0 0 0 1
1 0 0 0 l l 0 0 l l 0 0 0 0 0 1
1 0 0 0 l l 0 0 l l y 0 0 0 0 1
1 0 0 0 l l 0 0 l l 0 0 0 0 0 1
1 p 0 0 0 0 0 0 l l 0 0 x 0 0 1
1 0 0 0 0 0 0 0 l l 0 0 0 0 0 1
1 0 0 0 0 0 0 0 l l 0 0 0 0 0 1
1 0 0 0 l l 0 0 l l 0 0 0 0 0 0
1 0 0 0 l l 0 0 l l 0 0 0 0 0 0
1 1 1 1 1 1 1 1 1 1 1 1 1 1 1 1