1 1 1 1 1 1 1 1 1 1 1 1 1 0 0 1
1 y 0 i i i i i i i i 1 1 i i 1
1 0 0 i i i i i i i i 1 1 i i 1
1 i i i i i i i i i i 1 1 i i 1
1 i i i i i i i i i i 1 1 i i 1
1 i i i i i i i i i i 1 1 i i 1
1 i i i i i i i i i i 1 1 i i 1
1 i i i i i i i i 1 1 i i i i 1
1 i i i i i i i i 1 1 i i i i 1
1 i i i i i i i i 1 1 i i i i 1
1 i i i i i i i i 1 1 i i i i 1
1 i i i 1 1 1 1 1 1 1 1 1 i i 1
1 i i i 1 1 1 1 1 1 1 1 1 i i 1
1 x 0 i i i i 1 1 1 1 1 1 y 0 1
1 0 0 i i i i 1 1 1 1 1 1 0 0 1
1 1 1 1 1 0 0 1 1 1 1 1 1 1 1 1