1 1 1 1 1 1 1 1 1 1 1 1 1 1 1 1
1 1 1 1 1 1 i i i i 1 1 i i i 1
1 1 1 1 1 1 i i i i 1 1 i y 0 1
0 i i i 1 1 i i i i 1 1 i 0 0 1
0 i i i 1 1 i i 1 1 1 1 i i i 1
1 i i i 1 1 i i 1 1 1 1 i i i 1
1 i i i 1 1 i i 1 1 1 1 i i i 1
1 i i i 1 1 i i 1 1 1 1 i i i 1
1 i i i 1 1 i i 1 1 1 1 i i i 1
1 i i i 1 1 i i 1 1 1 1 i i i 1
1 i i i 1 1 y 0 1 1 1 1 i i i 1
1 i i i 1 1 0 0 1 1 1 1 i y 0 1
1 i i i 1 1 i i 1 1 1 1 i 0 0 1
1 i i i 1 1 i i 1 1 1 1 i i i 1
1 i i i 1 1 i i 1 1 1 1 i i i 1
1 1 1 1 1 1 1 1 1 1 1 1 0 0 1 1